5,0,5,monarch0301 (席哈),[問卦] 政府若要後備軍人出動防疫 各位準備好了,Sun May 16 09:27:26 2021
44,9,35,dream0821 (早餐很重要),[問卦] 錯誤的決策比貪污更可怕,Sun May 16 01:53:48 2021
31,10,21,Holmes7 (El Mundo),[問卦] 憑什麼華航不能倒啊？,Sun May 16 07:02:15 2021
34,4,30,nyu5765 (nyu5765),[問卦] 四級跟單日確診200位484距離不遠了,Sun May 16 06:48:45 2021
41,2,39,Style (神就是『光』就是『愛』),[問卦] 超商有客人沒戴口罩    ,Sun May 16 04:06:08 2021
8,0,8,thewtf (濱邊美波我老婆),[問卦] 大家洗翻貓貓嗎（有圖,Sun May 16 09:20:52 2021
52,5,47,yasionl (肥宅小妹),[問卦] 台灣是要示範三小？,Sun May 16 09:23:56 2021
12,1,11,indoman (橄欖趴),[問卦] 各位相信疫情控制的住吧,Sun May 16 08:33:51 2021
9,1,8,Behind4 (背後4),[問卦] 3+11 這波 會死多少人？,Sun May 16 05:32:16 2021
12,4,8,bigDwinsch (八德布勞內),[新聞] 違者重罰30萬！一表掌握「雙北5人禁聚令+9大指引」,Sun May 16 08:17:48 2021
0,0,0,joe255118 (酷比),[問卦] 早餐店老闆娘:「我比病毒更毒!」,Sun May 16 09:47:29 2021
8,7,1,c9c9c9ddde (愛喝可樂的貓),[問卦] 為啥不全台直接全部升四級警戒??,Sun May 16 08:53:31 2021
2,1,1,icehermit (ebb),Re,Sun May 16 08:18:12 2021
21,11,10,likem5 (溼府你好大),[問卦] 有沒有一早快篩站就一堆人,Sun May 16 06:48:29 2021
11,3,8,COCOCCC (COCOCCC),Re,Sun May 16 02:05:39 2021
1,0,1,jr10132000 (Radish),[問卦] 傳染病防治法的罰金,Sun May 16 07:44:58 2021
2,1,1,hayate232 (CY),Re,Sun May 16 03:48:54 2021
2,1,1,roelove (柔柔),Re,Sun May 16 06:06:03 2021
2,1,1,a1b2c3d4e5 (阿翔),[問卦] 強者我朋友從右投變左投了，慣用手都幾？,Sun May 16 07:51:40 2021
3,0,3,haijin (),[新聞]     強化疫苗保護力 比利時研究施打第3劑,Sun May 16 07:32:08 2021
0,0,0,Superxixai (洪粉吱已),[問卦] 覺青：我是人，我反核,Sun May 16 09:42:24 2021
23,0,23,qa1122z (19號),[問卦] 中華電這次會跌停嗎？,Sun May 16 07:34:36 2021
10,11,-1,KSHLO (Wunderbar),[問卦] 阿其實台灣就沒有真的爆緊張三小,Sun May 16 02:25:30 2021
10,6,4,sadelephant (我的大象在哭),[問卦] 有什麼話想對政府說,Sun May 16 06:17:58 2021
8,1,7,jeff785chen (raincat29),[問卦]現在給金正恩當CDC指揮官會怎樣,Sun May 16 07:52:46 2021
1,0,1,koil (雞兔哥),[問卦] 何時補助小黃,Sun May 16 08:17:10 2021
4,2,2,ssss0960193 (Florian),[問卦] 有防疫三寶的八卦嗎,Sun May 16 02:30:45 2021
1,1,0,hyuchi0202 (被刺激到了),Re,Sun May 16 03:46:00 2021
8,1,7,Dinenger (低能兒),Re,Sun May 16 01:59:25 2021
8,1,7,pttcat (letgoceltics),[問卦] 可以幫我家蛇蛇命名嗎,Sun May 16 09:19:35 2021
10,0,10,misaka0120 (野格炸彈),[問卦] 有沒有USADA的八卦,Sun May 16 02:54:14 2021
16,26,-10,xamous (一天死去一點),[新聞] 北市擴大篩檢確診數飆升 游淑慧：突顯衛,Sun May 16 09:38:19 2021
6,1,5,ezJapan (Japan),Re,Sun May 16 02:27:25 2021
4,3,1,naligono (那尼),[問卦] 往好處想 之後又有一堆券可抽了,Sun May 16 03:15:54 2021
6,3,3,vv22hh (v2h),[問卦]  命都不要了 也要放寬 是否有命更重要的,Sun May 16 02:28:44 2021
0,1,-1,muse87131 (),[問卦] 之前洗台灣人不用打疫苗的覺青呢？,Sun May 16 08:44:22 2021
4,0,4,werqq (sandy0980),Re,Sun May 16 07:55:16 2021
17,3,14,lovecyfen (lovecyfen),[問卦] 去年搶衛生紙跟今天搶購的是同一群北七,Sun May 16 01:55:24 2021
10,5,5,macaron5566 (ptt最真道理性的id),[問卦] 覺青洗小舞聊天室、按倒讚的八卦???,Sun May 16 09:26:45 2021
4,2,2,ivorysoap (ivorysoap),Re,Sun May 16 08:58:07 2021
10,2,8,sbilor (Ｍｒ成),[問卦] 台灣這次要感謝誰,Sun May 16 09:12:36 2021
5,0,5,wayne1027 (幹話百夫長),Re,Sun May 16 06:30:03 2021
23,0,23,lfnet4 (康叔),[問卦] 范錯了怎麼辦？,Sun May 16 08:35:35 2021
9,1,8,s72005ming (QQ),[問卦] 美國爸爸是不是總是能超前部署？,Sun May 16 07:17:25 2021
2,2,0,Bejita (Bejita),Re,Sun May 16 09:38:02 2021
5,1,4,hong1126 (ⒽⓄⓃⒼ①①②⑥是喵),[問卦]  有一種症 叫PTT症？,Sun May 16 08:37:18 2021
2,0,2,a88050488 (台灣巨砲陳江和),[問卦] 同島一命是矮化主權嗎,Sun May 16 04:33:32 2021
10,3,7,M4Tank (M4Tank),[問卦] 欸 如果國家防疫不周 能不能主張國賠啊？,Sun May 16 06:52:48 2021
4,0,4,ssdavid (^^),[問卦] 日本拉麵?韓國拉麵?,Sun May 16 02:20:36 2021
6,0,6,rsbbs0611428 (12),[問卦] WRESTLEMANIA摔角狂熱大賽？,Sun May 16 02:46:39 2021
30,3,27,SanyaMyBride (\桑妮雅最高/),[問卦] 臺北疫情大爆發，房價?,Sun May 16 09:22:55 2021
43,30,13,q347 (我家隔壁北川景子),[問卦] 幹你娘大西瓜,Sun May 16 08:20:27 2021
5,2,3,H23324216 (showtime),Re,Sun May 16 04:44:19 2021
6,1,5,jayway1983 (nobody),[問卦] ねね、高雄人口是不是要逆勢成漲了？,Sun May 16 08:50:24 2021
4,0,4,icewood1 (judas),[問卦] 鳳梨現在是買進的好時機嗎,Sun May 16 08:07:16 2021
6,1,5,cary4A240022 (關公面前耍大屌),[問卦] 千人公祭浮木突然消失政黑仔在想啥？,Sun May 16 09:20:37 2021
0,0,0,elless (鬼島歌王廢慾清),Re,Sun May 16 09:38:06 2021
58,2,56,RLAPH (川尻浩作),[問卦] 看好了！我只示範一次！！,Sun May 16 05:25:11 2021
6,0,6,kwinner (鯨魚),[問卦] 全聯員工有沒有加班費啊？,Sun May 16 09:04:11 2021
0,0,0,pideo (小佛),Re,Sun May 16 07:43:26 2021
1,3,-2,obovxxxxgay (obovxxxxgay),[問卦] 星座專家跟抗疫專家哪個給的生活指南實用,Sun May 16 07:53:56 2021
2,1,1,melissalewis (龍使弗利茲),[問卦] 這七局下班的攻勢是怎樣？,Sun May 16 08:36:28 2021
2,2,0,WeiU (微，Ｕ文),Re,Sun May 16 05:37:09 2021
96,1,95,pupss89177 (asshole young),Re,Sun May 16 07:21:59 2021
3,0,3,join183club (183club),Re,Sun May 16 04:51:41 2021
14,1,13,XDDDpupu5566 (XDpu56家族),[問卦] 機師很累，啊醫師、護理師不累？,Sun May 16 05:40:27 2021
4,0,4,maxjack (),[問卦] 肥仔這樣防疫會不會太over,Sun May 16 03:51:22 2021
8,3,5,zen0812 (王子的新衣),[問卦] sars 時期的中央政府,Sun May 16 06:25:59 2021
1,0,1,ericayou (vorka era),[問卦] 作文題目改成'我只示範一次'會更好寫嗎,Sun May 16 09:32:41 2021
37,4,33,askaleroux (Falcon),[問卦] 為什麼不宣布全國外出戴口罩,Sun May 16 07:44:42 2021
6,0,6,kauosong (如何一少年，匆匆已白頭),[問卦] 口號、製圖是不是證明文組治國很讚,Sun May 16 09:29:46 2021
1,1,0,kons (kons),Re,Sun May 16 03:46:00 2021
9,1,8,zzahoward (Cheshire Cat),Re,Sun May 16 09:33:30 2021
2,0,2,monine (),[問卦] 肥宅適合去當公車司機嗎？,Sun May 16 09:25:06 2021
34,1,33,xinghh (高雄魯肥宅QQ),[問卦] 會考完後會大爆發嗎？,Sun May 16 02:13:43 2021
10,3,7,kopuck (派翠克星星),[問卦] 誰教燕子築巢的？,Sun May 16 08:48:06 2021
4,3,1,Behind4 (背後4),[問卦] 華航怎麼有錢發年終？,Sun May 16 02:59:35 2021
3,2,1,dirty5566 (得體五六),[問卦] 哭惹 可以把看好了這句刊登在國際嗎,Sun May 16 04:06:30 2021
7,1,6,freertos (@@),[問卦] 好多筆電都賣完缺貨..?,Sun May 16 02:11:39 2021
4,0,4,hsshkisskiss (過去過不去),Re,Sun May 16 07:45:33 2021
3,2,1,ccyaztfe (best_troll_tw),Re,Sun May 16 08:23:00 2021
17,1,16,chen0625 (不知道要打什麼？),Re,Sun May 16 09:33:40 2021
8,3,5,jiunjie61 (Jiunjie),[問卦] 政府會強制打疫苗嗎？,Sun May 16 07:30:49 2021
26,0,26,sodistrues (true),[問卦]戰國戰神李牧帶五國合縱軍怎滅不掉秦國？,Sun May 16 06:58:01 2021
4,0,4,amoyui (clom),[問卦] 484要開始保護好家中長輩惹?,Sun May 16 08:35:38 2021
25,3,22,birdbaby (鳥寶貝>///<),[問卦] 台灣人是不是很中二？,Sun May 16 07:53:51 2021
5,0,5,mcgrady12336 (悼念鐘吉伯伯...),[問卦] 穩贏的局被四海遊龍該如何調適,Sun May 16 05:32:19 2021
1,0,1,hjgx (妳害了我的狗),[問卦] 484 Gai捐$了？,Sun May 16 08:27:39 2021
16,1,15,ANDORLESS (人生就是不斷地跌倒),[問卦] 為什麼這次防疫疫情鄉民都沒信心,Sun May 16 09:36:40 2021
3,0,3,TsukimiyaAyu (ㄎㄎㄎㄎㄎㄎㄎㄎㄎㄎㄎ),[問卦] 有沒有住蘆洲跟萬華者皆居家辦公的八卦？,Sun May 16 07:52:45 2021
2,0,2,RINPE (RIN),[問卦] 台灣人能抵制嗎？,Sun May 16 08:54:26 2021
5,0,5,AMDMARSHAL (你經營PTT比人生認真？),[問卦] 剛租下雙北店鋪的在想什麼,Sun May 16 02:59:06 2021
4,0,4,piggy37 (小時),[問卦] 騎車車停紅燈沒戴口算群聚嗎,Sun May 16 08:50:45 2021
3,0,3,johnson600 (johnson),[問卦] 病毒會自己選擇...？,Sun May 16 02:52:46 2021
3,1,2,yoshilin (意外跟明天那個先到?),[問卦] 民營金控補助自費疫苗,Sun May 16 07:37:04 2021
20,1,19,chen5566 (文心),[問卦] 中國人不應存在地球上,Sun May 16 09:28:30 2021
24,16,8,peggyfang (佩佩),[問卦]聽說台灣爆了 然後還不讓疫苗優先給醫護?,Sun May 16 02:23:31 2021
10,4,6,ok020402 (哦耶),[問卦] 台灣何時能跳脫 政治>一切,Sun May 16 03:03:05 2021
0,0,0,clessea (陽明就像大海),Re,Sun May 16 08:46:05 2021
14,0,14,wahaha23 (請勿拍打餵食),[爆卦] 20-21足總杯決賽,Sun May 16 02:09:51 2021
2,2,0,gerogexpg (Das Internetz),[問卦] 巴勒斯坦人會不會恨希特勒？,Sun May 16 05:20:55 2021
5,0,5,orangelolly (我戀橘羅莉。夏流),[問卦] 阿公店有什麼好玩的? 有八卦?,Sun May 16 09:37:58 2021
1,0,1,orangelolly (我戀橘羅莉。夏流),[問卦] 禮盒包裝，面試後變揪團購? 有八卦?,Sun May 16 09:13:23 2021
23,4,19,lovebuley (布里),[爆卦] 台大醫院降載,Sun May 16 09:16:31 2021
6,3,3,A6 (短ID真好),[爆卦] 台灣縣市疫情分布地圖(官方),Sun May 16 08:29:12 2021
9,5,4,zax5566rb (wetland),Re,Sun May 16 07:43:33 2021
14,0,14,badjye911 (阿三),[問卦] 聽說現在雙北路上都沒什麼人？,Sun May 16 09:04:21 2021
4,2,2,xu3 (賣女孩的小火柴),[問卦] 數學公式會變嗎？,Sun May 16 06:24:18 2021
28,1,27,asdzxc1662 (樂活吧),[問卦] 火神的眼淚熱度有輸天橋上的魔術師嗎？,Sun May 16 09:11:33 2021
3,1,2,join183club (183club),Re,Sun May 16 08:08:20 2021
10,3,7,cafupupu (順理以成章scannain),[問卦] 台北八大南下?,Sun May 16 03:03:02 2021
6,0,6,A1bertPujols (The Machine),[問卦] 外出有需要戴口罩嗎？,Sun May 16 07:32:06 2021
10,5,5,addison123 (鄉下小鮮肉),[問卦] 李義祥和那個范殺小誰比較可惡？,Sun May 16 08:39:39 2021
13,6,7,PVZVT (花開花落),[問卦] 夜郎國真的自大嗎？,Sun May 16 09:25:55 2021
3,0,3,Zcould (宇宙覺青網軍蟑螂),[問卦] 哪些國比台灣更不貪財不怕死不愛面子,Sun May 16 09:27:17 2021
12,3,9,hu610346 (新莊王拍融),[問卦] 會考完之後的國三,Sun May 16 07:50:19 2021
12,2,10,polyhome (小天),[問卦] 以後還會搭華航嗎,Sun May 16 07:10:15 2021
70,15,55,wya0108 (東京很熱),Re,Sun May 16 07:19:11 2021
1,1,0,poeta (鍵盤詩人),Re,Sun May 16 08:53:03 2021
3,3,0,longyin (龍吟很難嗎？為什麼),Re,Sun May 16 08:29:31 2021
0,0,0,kopuck (派翠克星星),[問卦] 肥宅示範一次 要示範什麼呢,Sun May 16 09:46:56 2021
3,1,2,lololol (APPLE),[問卦] 太魯閣募款10億，這次要募款多少？,Sun May 16 08:48:44 2021
7,2,5,Heyer (Heyer),[問卦]CHO484早就看破台灣？,Sun May 16 08:01:51 2021
0,0,0,kalababygi (海勒姆),Re,Sun May 16 09:27:43 2021
17,2,15,AlanLu (小憨呆),[問卦] 請問台灣有什麼事情是笑到最後的,Sun May 16 02:07:19 2021
54,2,52,d86249 (金羊),[問卦] 如果放無薪假怎麼活的八卦?,Sun May 16 03:07:21 2021
9,1,8,ALANMAPTT (夜雀),[問卦] 唐吉軻德有搶購物資潮嗎!?,Sun May 16 08:35:05 2021
12,1,11,bluebagel (果果:)),[問卦] 社區感染真的有成功擋下來的先例嗎？,Sun May 16 03:51:35 2021
8,1,7,Dinenger (低能兒),Re,Sun May 16 02:23:36 2021
2,0,2,ILYY (懶覺青),Re,Sun May 16 05:58:28 2021
10,2,8,goatcheese (goatcheese),[問卦] 紙箱對貓的吸引力怎麼這麼大？,Sun May 16 04:26:41 2021
4,0,4,moriyako (何妨吟嘯且徐行),[問卦] 武漢肺炎病毒484不想上班啊？,Sun May 16 08:40:02 2021
16,0,16,johntom (click),[問卦] 疫苗國家隊有無可能成立 ??,Sun May 16 07:48:28 2021
6,1,5,IhateOGC (我討厭),[問卦] 殭屍病毒來時要囤啥cp值最高？ 泡麵？,Sun May 16 03:59:01 2021
56,4,52,jojomickey2 (放開那個女孩),[問卦] 各地最低能口號有哪些??,Sun May 16 01:59:33 2021
1,0,1,itisverycold (Joe蔡),Re,Sun May 16 02:56:27 2021
4,1,3,curlymonkey (curlymonkey),[問卦] 去年4月我們還在討論海軍磐石艦的難言之,Sun May 16 06:56:28 2021
2,2,0,f912912 (shuku),Re,Sun May 16 07:57:11 2021
3,0,3,pornstar (迪克),[問卦] 所以海歸仔現在是不是最安全的？,Sun May 16 08:18:26 2021
3,0,3,ClutchShot (ClutchShot),[問卦] 有症狀民眾可以快篩484就不會爆發,Sun May 16 07:51:55 2021
0,0,0,rocky9137No2 (麥寮衛生棉),[問卦] 架上只剩韓國泡麵,Sun May 16 09:48:44 2021
4,1,3,kll95 (95),[問卦] 不要一直針對華航機師耶,Sun May 16 05:56:56 2021
0,0,0,winnabe (請你不要迷戀哥),Re,Sun May 16 09:47:17 2021
38,0,38,cramwall (等待),[問卦] 這次政府會灑幣嗎？,Sun May 16 07:45:53 2021
6,0,6,nbarepeat (nbarepeat),[問卦] 理工被文組管,Sun May 16 08:14:05 2021
0,0,0,spiral0857 (從今以後),[問卦] 防疫指揮部心態像不像打LOL大順風時？,Sun May 16 09:48:17 2021
9,1,8,nissan168 (pingGO),[問卦] 疫苗到底多久可以普及？,Sun May 16 01:53:03 2021
3,1,2,CS7788 (肥宅),Re,Sun May 16 09:31:57 2021
21,6,15,s3122762120 (栗悟飯とカメハメ波),[問卦] 比別人多一年時間準備為何還亂成一鍋粥,Sun May 16 09:39:02 2021
12,0,12,lovecyfen (lovecyfen),[問卦] 台灣人何時要開始搶購塔位跟墓地??,Sun May 16 02:04:47 2021
3,0,3,zxhzshsrm (鄉下老實人),[問卦] 現在你們還會去買自助餐嗎？,Sun May 16 08:38:19 2021
6,9,-3,earltyro (伯茶),[問卦] 自私逃離：我們真的比武漢人好多少嗎？,Sun May 16 09:16:14 2021
4,0,4,kevin1212 (yhc),[問卦] 是不是遲早疫情都會爆炸,Sun May 16 08:22:34 2021
11,2,9,puritylife (purity),Re,Sun May 16 01:48:28 2021
0,0,0,thjyrsj (千里),[問卦] 考試有那麼重要嗎？,Sun May 16 09:42:59 2021
4,0,4,wei115 (尼特。),[問卦] ptt開放API有搞頭嗎？,Sun May 16 04:49:11 2021
0,0,0,LeonardoChen (LeonardoChen),Re,Sun May 16 02:34:24 2021
2,0,2,BleedWang (),Re,Sun May 16 08:20:28 2021
9,0,9,ipapa (),[問卦] 抖音熱歌是不是連覺青都凍未條,Sun May 16 07:43:01 2021
68,13,55,cuba391156 (cuba391156),[問卦] 我妹壽星堅持出門慶生怎辦？,Sun May 16 07:55:36 2021
17,1,16,Tamama56 (日向喵),[問卦] 此次病毒是不是耐熱？,Sun May 16 06:59:44 2021
1,0,1,s66449 (老實樣),[問卦] 肥宅最近不吃魚喝茶有加分嗎？,Sun May 16 07:51:56 2021
0,0,0,remora (remora),[問卦] 只示範一次是不是在立flag?,Sun May 16 09:48:28 2021
0,0,0,HuangYa (後山小田切讓),[問卦] 現在去犯罪被關484最佳解?,Sun May 16 09:44:43 2021
11,6,5,if7 (夏天),[問卦] 對岸不帶口罩的卦,Sun May 16 02:21:35 2021
13,6,7,plusseal (seal),[問卦] 這時間還沒睡的在幹嘛,Sun May 16 04:38:04 2021
0,0,0,thumbbat (終於),Re,Sun May 16 06:23:32 2021
30,7,23,z1976 (z1976是，靠，好像在開小),[問卦] 其實升級四級一週反而能解決問題吧,Sun May 16 08:16:48 2021
0,0,0,crashonU (crazy),[新聞] 萬華不封區理由曝光 ！柯文哲提「A的N次,Sun May 16 09:47:05 2021
22,1,21,onlytfgsu (PCGAMEKER),[問卦] 儘快封鎖北部疫民 避免擴散高雄,Sun May 16 03:23:12 2021
25,1,24,xxxcv (世界遺產旅遊計畫),[問卦] 台大醫院檢查暫停2週,Sun May 16 08:49:27 2021
1,0,1,PPP720817 (酸宅),[問卦] 肥宅是不是比較安全??,Sun May 16 03:51:29 2021
1,0,1,maxw1102 (帥麥),[問卦] 有沒有很多人去醫院吹冷氣的卦？,Sun May 16 09:22:33 2021
180,28,152,kaidi620 (萬能史哥),[爆卦] 新加坡17日起禁來自台灣旅客入境,Sun May 16 02:51:24 2021
4,1,3,movingcastle (霍爾的偶爾才移動城堡),[問卦] 要怎麼勸長輩,Sun May 16 06:23:28 2021
194,16,178,Ericz7000 (),[問卦] 每推1p也能爆嗎？,Sun May 16 09:33:06 2021
1,0,1,dogwww (純情小百合),[問卦] 有沒有人與屁連結的八卦？,Sun May 16 05:45:32 2021
3,0,3,yoyoflag (伊莉一咻),[問卦] 關指部喝酒上兵 484料敵如神的先知?,Sun May 16 03:44:27 2021
0,1,-1,chairman129 (chairman129),Re,Sun May 16 03:44:16 2021
1,1,0,lionan79826 (鉛筆王),[問卦] 請問要示範幾次？,Sun May 16 05:25:30 2021
5,0,5,shiauji (Transitory),[問卦] 有人沒開冷氣，但早上被熱醒的嗎,Sun May 16 08:33:59 2021
1,0,1,orze04 (orz),Re,Sun May 16 05:28:23 2021
6,1,5,m4vu0 (m4vu0),[問卦] 520要送什麼給女同事阿香,Sun May 16 02:20:56 2021
9,3,6,efthu456 (小哲),[問卦] 洗完澡手很癢怎辦？,Sun May 16 02:14:56 2021
17,0,17,gankgf (國際曱甴保育員),[問卦] 要發什麼文才能鼓舞人心？,Sun May 16 08:18:36 2021
0,0,0,honor997 (唉唷),[問卦] 台灣中南部水庫剩餘量,Sun May 16 09:45:13 2021
41,10,31,u92202 (綠茶無糖少冰),[問卦] 為什麼要囤泡麵？,Sun May 16 02:29:26 2021
13,2,11,mucorn (MU),[問卦] 所以有醫師對3+11背書嗎？,Sun May 16 09:39:59 2021
76,13,63,Lucky0105 (洋),[問卦] 早餐店阿婆：「這麼熱細菌不敢進來。」,Sun May 16 07:02:18 2021
0,1,-1,yoshilin (意外跟明天那個先到?),Re,Sun May 16 07:53:34 2021
14,1,13,Bionut (生物堅果),Re,Sun May 16 01:45:22 2021
1,2,-1,noah5566 (noah5566),[問卦] 全家薯餅三明治,Sun May 16 08:34:22 2021
2,0,2,HOWyun2648 (無用之用是為用),Re,Sun May 16 05:52:01 2021
48,2,46,Freeven (夏舞楓),[問卦] 半個月之後沒水了怎麼生活？,Sun May 16 08:44:33 2021
0,0,0,kinda (天天),[問卦] 世界越快，心，則慢。,Sun May 16 09:45:00 2021
4,6,-2,puppy5271 (puppy),疫情看人品 （無腦多）,Sun May 16 01:52:11 2
1,2,-1,howard612 (),Re,Sun May 16 07:24:53 2021
3,1,2,Holmes7 (El Mundo),[問卦] 武漢肺炎本土疫情加劇疫苗夠嗎？,Sun May 16 07:20:34 2021
5,0,5,aynmeow (我想成為安康魚),Re,Sun May 16 08:27:28 2021
19,54,-35,DoUSmell (斯文牙醫),[問卦] 一堆見獵心喜的外省仔,Sun May 16 08:56:15 2021
27,0,27,Santander (anything is possible),[新聞] 印度天天破30萬確診 日本下周將派機接回僑民,Sun May 16 09:08:43 2021
5,2,3,bathilda (bat),[問卦] 那英是不是頂級女歌手,Sun May 16 03:32:00 2021
4,0,4,fytnship (<(￣︶￣)>),Re,Sun May 16 08:39:52 2021
7,1,6,disney82231 (小刀會序曲),[問卦] 醫療系統有可能過載嗎,Sun May 16 09:10:49 2021
4,2,2,popo1234 (我很好騙),[問卦] 代議政治是走到這步田地的關鍵嗎？,Sun May 16 09:22:44 2021
10,3,7,nawussica (暴民好弱 ),[問卦] 方艙醫院何時開始架設,Sun May 16 08:51:25 2021
6,5,1,frrr (franky1),[問卦] 已經all in狗狗幣的人多嗎,Sun May 16 06:20:37 2021
47,43,4,cloud72426 (數字只是輔助不是真理),[問卦] +180是之前根本沒驗吧,Sun May 16 07:09:45 2021
116,37,79,lovea (lovea),[問卦] 所以台灣之前只是窩在新手村自嗨而已....,Sun May 16 09:06:04 2021
7,11,-4,zen0812 (王子的新衣),[問卦]  低調的衛生局長,Sun May 16 06:42:00 2021
1,0,1,ezJapan (Japan),Re,Sun May 16 09:22:28 2021
0,0,0,arsonlolita (蘿莉塔大魔王),[公告] 八卦板板規(2021.05.11),Tue May 11 15:03:06 2021
0,0,0,kauosong (如何一少年，匆匆已白頭),[問卦] 台灣的口號是不是媲美超英趕美？,Sun May 16 09:46:36 2021
10,1,9,d86249 (金羊),[問卦] 有人會擔心軍營成突破口嗎?,Sun May 16 07:47:31 2021
5,0,5,isequ (動起來~),[問卦]  有沒有半夜上ptt才不會過載的八卦,Sun May 16 05:34:31 2021
17,3,14,happyalex (單眼皮滴男生),[問卦] 可以幫忙建議夜市休3天擺一天嗎？,Sun May 16 09:14:29 2021
13,11,2,ltony01 (ltony01),[問卦] 約到一個正妹但是確診你敢上嗎,Sun May 16 02:20:02 2021
8,0,8,kerberoSun (學投胎卡實在),[問卦] 如何示範一手好牌玩到爛,Sun May 16 02:46:51 2021
6,0,6,mossdevin (Devin Moss 10發育期有?5),[問卦] 華航公關是不是很失敗？,Sun May 16 09:23:17 2021
22,36,-14,deign (俯允),[問卦] 去年普篩掰說有假陽性，180人快篩反而沒,Sun May 16 09:02:35 2021
12,3,9,pp5434 (),[問卦] 是不是應該暫時分開比較好一點,Sun May 16 06:35:02 2021
4,1,3,tmdl (tmdl),[問卦] 如果病毒圍堵成功...,Sun May 16 08:27:48 2021
1,0,1,longyin (龍吟很難嗎？為什麼),Re,Sun May 16 06:34:26 2021
9,2,7,Geison (Angels),[問卦] 萬華的竹筍是不是比較好吃？,Sun May 16 01:49:10 2021
6,1,5,ccyaztfe (best_troll_tw),[問卦] 疫情證明手機臉孔辨識系統很不方便吧,Sun May 16 08:00:33 2021
53,9,44,pin999888pin (想飛的魚),[問卦] 道歉？對公共人物來說是不是很難！,Sun May 16 06:21:53 2021
3,0,3,yoshilin (意外跟明天那個先到?),Re,Sun May 16 07:25:30 2021
2,0,2,bota (llll),[問卦] 大家會不會擔心國軍的異地辦公???,Sun May 16 08:45:50 2021
16,1,15,curlymonkey (curlymonkey),[問卦] 國中會考防疫措施感想？,Sun May 16 07:20:59 2021
4,1,3,SuperSg (○(#‵ ︿′ㄨ)○森77),Re,Sun May 16 08:50:12 2021
9,0,9,abc0312 (ABC),Re,Sun May 16 07:45:18 2021
1,0,1,poeta (鍵盤詩人),Re,Sun May 16 08:41:24 2021
7,14,-7,NightStick (龐德任),[問卦] 我朋友的老公外遇了，還高姿態是怎樣？,Sun May 16 08:37:28 2021
4,0,4,shotholisi (呆れて白目をむく),Re,Sun May 16 03:51:52 2021
7,3,4,ivorysoap (ivorysoap),[問卦]各位有沒有因為昨天疫情升級而不用工作的,Sun May 16 08:45:01 2021
4,1,3,caeasonfb (eason),Re,Sun May 16 09:25:51 2021
7,4,3,Supasizeit (更大更快更有力),[問卦] 美國爸爸會不會來救我棉,Sun May 16 02:15:42 2021
2,0,2,chen5293 (o.m),Re,Sun May 16 06:32:29 2021
7,2,5,gologo (),[問卦] 阿甘正傳為什麼不拍個續集?,Sun May 16 06:11:13 2021
5,0,5,lohsusheng (tony),Re,Sun May 16 09:01:30 2021
25,0,25,fransiceyho (天氣很棒),[問卦] 為什麼北北基國中小不停課？,Sun May 16 09:06:04 2021
5,6,-1,yamason (亞麻桑),[問卦] 公司微波爐大家共用會傳染嗎,Sun May 16 02:02:53 2021
6,1,5,King5566 (小兔子暗黑無限破),[問卦] 弄成這樣不用換人？？,Sun May 16 07:51:23 2021
4,4,0,AngelsDemon (你媽把你養大跑去當太監),[問卦] 我只示範一次,Sun May 16 09:37:33 2021
5,0,5,hcbr (hcbr),Re,Sun May 16 09:35:23 2021
109,24,85,juyhnmki (juyhnmki),[問卦] 越來越討厭機師了怎辦？,Sun May 16 08:46:11 2021
72,29,43,iecju520 (哎依喜德魯),[問卦] 最該死的是華航機師吧,Sun May 16 01:47:03 2021
7,0,7,hateOnas (人類沒有心臟那就好了),[問卦] 台灣社交距離 為什麼要開藍芽？,Sun May 16 06:25:30 2021
6,0,6,melissalewis (龍使弗利茲),[問卦] 高雄還不把門關起來嗎？,Sun May 16 03:27:17 2021
4,0,4,sk050607 (板橋Vettel),[問卦] 華航、台鐵，官股背景是不是原罪？,Sun May 16 09:16:00 2021
40,7,33,deltaz (我還懂不懂飛翔),[問卦] 防疫破口到底誰負責,Sun May 16 05:58:49 2021
40,2,38,no10798254 (扛爸子),[問卦] 有沒有雙響泡的後台八卦?,Sun May 16 07:26:32 2021
0,0,0,Lawleit (大員郭奉孝),[問卦] 豆導在導床戲時會示範一次嗎？,Sun May 16 09:44:50 2021
13,10,3,celebe (批踢踢程式人),[問卦] 臺灣社交距離 App - iOS,Sun May 16 08:43:34 2021
6,4,2,zen0812 (王子的新衣),[問卦] 有沒有一句話給政府打氣？,Sun May 16 07:41:28 2021
4,0,4,traman (無名),Re,Sun May 16 09:27:34 2021
17,5,12,taiwannext (2016綠營重新執政 ),[問卦]為什麼3級之前說室外路上沒戴口罩必要？,Sun May 16 08:22:39 2021
5,0,5,jokerming847 (娜塔亞的非難),[問卦] 有沒有預言一定要實現的八卦,Sun May 16 04:40:16 2021
126,43,83,Claire126 (雨),[新聞] 本土疫情大爆發 負壓隔離病房「僅剩298床,Sun May 16 08:24:08 2021
4,2,2,lilskies (K他命),[問卦]  還不封城鎖國嗎,Sun May 16 08:28:22 2021
0,1,-1,yoyoflag (伊莉一咻),Re,Sun May 16 07:49:09 2021
3,0,3,s84629 (wizkhaaaaa),Re,Sun May 16 06:47:07 2021
23,3,20,eric2099 (eric2099),Re,Sun May 16 02:22:01 2021
9,0,9,alexsilva (股板雜空韭菜),[問卦] 跟數學老斯說3+11=180會被數學老斯打嗎,Sun May 16 04:59:48 2021
4,1,3,zsert13322 (R可),[問卦] 看好了 PTT 我只示範一次發廢文,Sun May 16 04:46:50 2021
19,0,19,askaleroux (Falcon),[新聞] 南市娛樂場所停業 一晚查到10店家違規,Sun May 16 09:38:10 2021
6,4,2,jedy05097952 (hiro),[問卦] 聚會訂位不給退訂費,Sun May 16 05:17:21 2021
1,0,1,a0912pudding (a0912pudding),[問卦] 有沒有人針對華航管理不善提案賠償,Sun May 16 08:44:10 2021
0,0,0,chen5566 (文心),[問卦] 有電影 惡水真相的卦嗎,Sun May 16 09:47:22 2021
3,2,1,kuijun228 (Daoko小粉絲),Re,Sun May 16 02:44:04 2021
5,1,4,bbsbox (bbsbox),[問卦] 要怎樣一句話電沒戴口罩的人？,Sun May 16 09:37:23 2021
10,1,9,samp05 (生活總有新鮮事),[問卦] 現在出門採買來的及嗎？,Sun May 16 08:41:32 2021
8,2,6,slovea (廢物文組傳產學徒),[問卦] 急就章的囤貨仔都買了些什麼呀,Sun May 16 08:56:48 2021
4,5,-1,luckytinasui (藍靛紫),[問卦] 484該買健身環啦0_0？,Sun May 16 03:07:07 2021
3,1,2,RINPE (RIN),[問卦] 有多少人會偷來？,Sun May 16 05:52:30 2021
30,2,28,aragornwill (ichiro),[問卦] 什麼事情只示範一次最屌?,Sun May 16 07:12:29 2021
9,1,8,xinghh (高雄魯肥宅QQ),[問卦] 嘴巴破洞好痛,Sun May 16 05:55:11 2021
0,0,0,kb0130 (烏拉拉),Re,Sun May 16 09:48:36 2021
5,0,5,YYC042 (早已慣),[問卦] 有人現在坐台鐵對號 還有人站嗎？,Sun May 16 08:03:43 2021
0,0,0,KoujikiOuji (古事記王子),Re,Sun May 16 02:12:55 2021
5,0,5,ljsnonocat2 (凡所有相皆是虛妄),Re,Sun May 16 08:36:11 2021
19,12,7,pejan (誰還想當醫生?硍),[問卦] 看好了 全世界 ，我只示範一次..,Sun May 16 03:00:39 2021
0,0,0,z1120123 (dogisgood),[問卦] 缺水缺電有多可怕？？,Sun May 16 09:41:41 2021
17,7,10,IDfor2010 (116),Re,Sun May 16 03:11:15 2021
3,0,3,rote (ROTE),Re,Sun May 16 02:07:47 2021
1,1,0,lpbrother (LP哥(LP = Love & Peace)),Re,Sun May 16 08:39:49 2021
6,0,6,PPAPwww (pan),[問卦] 華航出事  全民買單?,Sun May 16 07:17:37 2021
3,0,3,callhek (沒錢住帝寶),[問卦] 老伯：看動畫的人大多數沒有錢！,Sun May 16 08:35:34 2021
2,5,-3,hahagirls (布丁),Re,Sun May 16 02:48:05 2021
1,1,0,mimi1020b (法海不是不懂愛),Re,Sun May 16 05:59:01 2021
9,10,-1,devidevi (凱特),Re,Sun May 16 09:10:07 2021
63,13,50,a606152004 (吐槽役),[問卦] 禁止室內5人以上聚會 但可以上班課？,Sun May 16 03:30:07 2021
10,1,9,babylickme (寶貝常常打我> <),[問卦] 病毒會有消失ㄧ天嗎,Sun May 16 08:16:32 2021
5,4,1,ilw4e (可以吃嗎？),Re,Sun May 16 07:34:46 2021
23,2,21,poeta (鍵盤詩人),[問卦] 為啥不用電子發票載具當實聯,Sun May 16 07:43:01 2021
30,2,28,y22710616 (鱔魚王),[問卦] 今天的疫情記者會,Sun May 16 09:21:49 2021
9,1,8,lesnaree2 ( ),[問卦] 世界看好了 開除黨內黑道 只示範一次！,Sun May 16 07:52:13 2021
5,4,1,Kidd00 ([email protected][email protected]~),[問卦] 有人要示範一分鐘內噓文到XX嗎？,Sun May 16 07:42:43 2021
6,2,4,s72005ming (QQ),[問卦] 沒設性專區的地方政府也有錯吧？,Sun May 16 07:32:31 2021
32,2,30,jinnsei (人生),[問卦] 怎麼不用水且不用電做出一餐,Sun May 16 07:35:55 2021
4,0,4,orangekafka (安安你好),[問卦] 現在辦美國疫苗團有搞頭嗎,Sun May 16 09:11:30 2021
13,6,7,rick102233 (),[問卦] 是不是該請求祖國協助台灣防疫了？,Sun May 16 09:12:23 2021
21,15,6,alexsilva (股板雜空韭菜),[問卦] 發現正妹朋友的ptt id該跟她坦承嗎？,Sun May 16 04:18:38 2021
6,0,6,zxcv820421 (水原千鶴我老婆),Re,Sun May 16 01:55:49 2021
3,4,-1,ericekin (哈囉啊),[問卦]戶外一堆人，是不是趕緊趁現在，不然等到,Sun May 16 09:20:02 2021
5,0,5,NCKUFatPork (成大肥宅悲歌),Re,Sun May 16 07:42:18 2021
281,13,268,soulboy330 (stay the course),Re,Sun May 16 03:24:04 2021
45,131,-86,tsukiji (大司壽),[新聞] 疫情嚴峻民眾「自動封城」 日網友大讚：,Sun May 16 07:07:12 2021
0,0,0,asxc530530 (4個不同意，才會有冷氣),[問卦] 這次是輸在台灣人自己太嘴砲 不打疫苗吧?,Sun May 16 09:47:48 2021
28,2,26,semna (11),[問卦] 這次台灣疫情誰才是最大贏家？,Sun May 16 02:18:42 2021
30,2,28,srwcc (老馬),[問卦] 疫苗的風險是小還是大？,Sun May 16 08:51:49 2021
2,1,1,AgentSkye56 (大安周渝民),[問卦] 所以確診的人有強制隔離嗎,Sun May 16 09:38:37 2021
4,1,3,a323214 (夜琉璃),[問卦] 現代人都靠玩口罩搏版面？,Sun May 16 02:33:07 2021
4,0,4,jwdream (jwdream),[問卦] 一般小店家用實聯制可以嗎,Sun May 16 05:43:49 2021
6,0,6,Sylph (炁),[問卦] 我這樣很壞心嗎？,Sun May 16 08:16:16 2021
44,7,37,jiern (jiern),[新聞] 范雲3+11害9縣市淪陷？她揪真凶竟是「民,Sun May 16 09:33:14 2021
5,2,3,songgood (ilovegoodgame),[問卦] 艾達王是不是覺得自已配不上李昂,Sun May 16 09:25:42 2021
10,7,3,skylin (自由翱翔),[問卦] 現在被外國人笑萬華肺炎怎麼辦？,Sun May 16 09:04:01 2021
30,14,16,ubcs (覺★青年超冒險蓋),[公告] 雙北防疫升三級請減少外出 小心戴口罩,Sat May 15 12:34:22 2021
0,0,0,oz5566 (威廉。霍恩索倫),Re,Sun May 16 07:17:50 2021
9,0,9,erikaptt (12345),[問卦]在戶外不戴口罩 別人也奈你何吧?,Sun May 16 07:54:32 2021
19,2,17,aivxg (家裡窮西索XD),[問卦] 醫療體系崩潰的話會怎樣...？,Sun May 16 08:17:32 2021
10,5,5,kuma525566 (毛怪),[問卦] 欸！買了車卻因為疫情不敢出門?,Sun May 16 07:40:16 2021
1,4,-3,viable (隱士灰原I),Re,Sun May 16 02:08:03 2021
2,1,1,attpp (小豬呱呱叫),[問卦] 有沒有住院賺錢過生活的八卦,Sun May 16 09:28:54 2021
4,0,4,semna (11),Re,Sun May 16 02:02:37 2021
4,3,1,poppyvampire ( ),[問卦] Taiwan can help會不變Taiwan needs help,Sun May 16 02:23:36 2021
58,9,49,LittleTT (LittleT),[問卦] 剛剛打完第二針了 自由了嗎？,Sun May 16 03:54:05 2021
1,0,1,VVVV55555 (東興烏鴉-小妹),[問卦] 違停都管理不了了，怎麼抓路上沒戴口罩？,Sun May 16 01:52:17 2021
6,2,4,soulfully (soulfulness),[問卦] 原來真正的芒果乾是這樣的感覺…,Sun May 16 09:27:15 2021
6,1,5,medlife0830 (allen game),[問卦] 祖國會怎樣處理違規的機師？,Sun May 16 09:20:36 2021
6,1,5,philae1112 (接輿),Re,Sun May 16 06:45:10 2021
167,96,71,KingChaly (ROC Dream),[問卦] 怎麼沒人要究責陳時中？？？,Sun May 16 08:55:30 2021
7,6,1,kodak2222 (唔...),[問卦] 幹麼不封城?,Sun May 16 01:44:53 2021
6,2,4,obrag (歐布拉),[問卦] 現金是不是防疫破口？,Sun May 16 02:06:15 2021
0,0,0,PHINEAR (忙完 我回來了),Re,Sun May 16 08:37:13 2021
2,3,-1,Jimny5566 (大谷川一),Re,Sun May 16 03:09:05 2021
11,2,9,yun0615ch (阿毛毛),[問卦] 機師 空姐 會覺得自己高人一等嗎？,Sun May 16 08:14:00 2021
1,1,0,hjgx (妳害了我的狗),Re,Sun May 16 09:04:27 2021
201,66,135,jacklyl (全力殲滅糞兔兔卡娜赫拉),Re,Sun May 16 03:20:10 2021
1,1,0,Zeropapa (吱支失智笑話列車航行中~),Re,Sun May 16 09:14:57 2021
4,3,1,jpgjpg2005 (未看先猜小喵),[問卦] 大家會希望確診人數降低嗎,Sun May 16 02:17:31 2021
5,1,4,ATTwo (咖哩給Gay),[問卦] 拳世郎只示範一次，會用哪招,Sun May 16 09:38:41 2021
36,3,33,shirokase (氧化鋼刺),Re,Sun May 16 08:41:14 2021
4,1,3,taiga666 (太賀),[問卦] 只會呼口號是不是有點粉紅,Sun May 16 09:28:15 2021
15,1,14,qwqwaas (MADE),[問卦] 全聯室內超過100人了吧?,Sun May 16 04:35:27 2021
136,14,122,Taiwannapa1 (我川威武),[問卦] 連夜逃離台北的人在想什麼？,Sun May 16 02:16:35 2021
106,19,87,behaveber (淡江何金銀),[問卦] 為什麼覺青都愛講一些讓人尷尬的話,Sun May 16 04:00:21 2021
1,5,-4,gay7788 (卡稱之神=卡神),[問卦] 有人會只肛一次嗎？,Sun May 16 09:35:12 2021
14,17,-3,shonbig (香檳),[問卦] 為什麼很多人這麼氣,Sun May 16 07:57:14 2021
8,1,7,uu70904 (人生海海),[問卦] 覺得會有第二波紓困方案嗎？,Sun May 16 07:44:40 2021
1,2,-1,AKS8158 (車がほしいです),[問卦] 如何避開戴奧辛,Sun May 16 07:55:53 2021
8,15,-7,B0858B (),[新聞] 本周末國中會考如期舉行 蔡英文請考生和,Sun May 16 07:06:46 2021
4,1,3,thelittleone (thelittleone),[問卦] 大家有看過真正的青花瓷嗎?,Sun May 16 03:52:32 2021
6,0,6,inet (),[問卦] 國安基金的錢夠嗎？,Sun May 16 09:25:09 2021
1,0,1,Beanoodle (津崎似超人平匡先生),Re,Sun May 16 09:24:16 2021
9,0,9,ysb727 (車干),[問卦] 到底要不要聽雙北高中大學的課啊？,Sun May 16 09:01:26 2021
11,0,11,jplix (~(@[email protected])~),[問卦] 其實台灣人明明很在意國外的看法吧,Sun May 16 06:49:20 2021
13,3,10,j022015 (一大包蛋糕邊足夠了),[問卦] 為什麼要替破壞防疫的人承擔後果,Sun May 16 01:53:50 2021
15,0,15,senma (ライフ☆ライン),[問卦] 台灣只剩下我沒喝茶？,Sun May 16 08:24:44 2021
13,5,8,new1974 (風浮草),[問卦] 台灣對外勞的管理，是否太鬆散？,Sun May 16 06:30:53 2021
24,3,21,rich22084 (Siro),Re,Sun May 16 01:55:49 2021
25,1,24,cvngoo (goo),[問卦] 所以現在就是闖禍的不用負責就是了?,Sun May 16 09:20:45 2021
1,9,-8,poupy (皮),不然口號要怎麼喊你們才會滿意,Sun May 16 07:51:29 2021
3,6,-3,a45741lb (曉欺),讓全民進入新兵訓練戰備是不是比較好,Sun May 16 06:39:09 2021
13,1,12,roy2142 (roy),[問卦] wfh後全國用電量484要爆了,Sun May 16 09:23:16 2021
3,1,2,kronioel (鵝妹子英在回台灣的事情 ),Re,Sun May 16 02:06:12 2021
9,3,6,Hitotoiro ( ),[問卦] 梵諦岡是不是世上處男密度最高的國家,Sun May 16 02:26:07 2021
7,3,4,bota (llll),Re,Sun May 16 06:50:15 2021
8,1,7,GGINDOWBOW (吃肥肥裝頹頹),[問卦] 台版吳三桂會有什麼下場？,Sun May 16 08:27:26 2021
11,0,11,a1005100 (dab),Re,Sun May 16 06:19:09 2021
1,0,1,kinki999 (QQk 廢文被劣文中),[問卦] 人民自律，是誰不自律?,Sun May 16 09:22:50 2021
10,2,8,TaiwanDPP (偉),[問卦] 台灣在這個階段嗎？,Sun May 16 09:40:29 2021
114,200,-86,ubcs (覺★青年超冒險蓋),[公告] 置底大怒灌Hate閒聊區,Fri May 14 13:58:47 2021
21,3,18,ulycess (ulycess),[問卦] 台北市的教師甄審為什麼不延期？,Sun May 16 07:38:53 2021
2,2,0,thewtf (濱邊美波我老婆),[問卦] 這是什麼星座（有圖）,Sun May 16 08:52:41 2021
3,0,3,YOYOISGOOD (YOYOISGOOD),[問卦] 現在出入通行還只用體溫判斷可行嗎？,Sun May 16 07:28:43 2021
7,3,4,naligono (那尼),[問卦] 看好了世界我只示範一次兩週大便一次沖,Sun May 16 03:27:31 2021
23,4,19,kingtama (立志成為唬爛王),[問卦] 我只示範一次英文怎麼講？,Sun May 16 07:02:12 2021
19,0,19,SM19 (詐騙聲音集團首腦Q_Q),[問卦] 台灣目前該準備甚,Sun May 16 09:30:49 2021
2,1,1,muse87131 (),[問卦] 每個文化都有比防疫更重要的事吧？,Sun May 16 08:17:31 2021
20,3,17,IMISSYOI (佑),[新聞] 新竹縣疑似出現確診病童 幼兒園家長漏夜,Sun May 16 09:33:28 2021
0,2,-2,honyan (honyan),[問卦] 陰德互助會，願防疫力與你同在,Sun May 16 04:58:33 2021
4,2,2,poeta (鍵盤詩人),[問卦] 房東阿姨說 他也很辛苦,Sun May 16 07:03:30 2021
2,0,2,jerrylin (金錢就是力量),Re,Sun May 16 01:53:54 2021
0,0,0,rikey0214 (天上掉下來的牙籤),[問卦] 看好了世界是不是套牢仔在自慰?,Sun May 16 03:50:45 2021
12,5,7,qwqwaas (MADE),[新聞] 李愛綺防疫健身房停業50萬飛了,Sun May 16 09:05:58 2021
7,1,6,aallens (ALLENS),Re,Sun May 16 06:16:15 2021
2,0,2,Nagato (長門),[問卦] 台灣明天就會有人打第二劑了,Sun May 16 06:55:27 2021
15,20,-5,eddisontw (沙丘),[新聞] 「動物園」也算公有場館！　民眾一早撲空,Sun May 16 06:43:44 2021
10,2,8,nbarepeat (nbarepeat),[問卦] 去你的文字勝利法,Sun May 16 05:36:17 2021
6,0,6,saniblue (sanity),Re,Sun May 16 04:43:33 2021
12,3,9,xpsecret (雙層純牛肉),[問卦] 國軍這波疫情如果炸裂的話？,Sun May 16 08:29:04 2021
2,0,2,orze04 (orz),Re,Sun May 16 03:34:48 2021
2,0,2,Whitening (whitening),Re,Sun May 16 09:20:52 2021
10,0,10,mucorn (MU),[問卦] 相信臺灣人民素質嗎？,Sun May 16 07:54:44 2021
3,3,0,vinsmokesanj (反串逆),[問卦] 唉 過路實名制 為何不用健保卡啊?,Sun May 16 03:19:59 2021
45,7,38,q347 (我家隔壁北川景子),[問卦] 這批怎麼還沒有人幫醫護加油?? (發錢),Sun May 16 07:09:42 2021
130,20,110,gaiaesque (一起來聽techno八 o'_'o),[問卦] 幹 左岸小學數學出這種題目 o'_'o,Sun May 16 08:00:54 2021
47,4,43,Ryo5566 (),[新聞] 「阿姨也在茶室工作」病患家屬緊急隔離！,Sun May 16 07:24:37 2021
38,14,24,zrct5566 (美麗又殘酷的世界),[問卦] 以前的人為什麼不讓女人參與公共事務,Sun May 16 07:36:17 2021
19,3,16,nber0910 (小賴),[問卦] 看好了世界台灣人只示範一次在兩週內解,Sun May 16 04:33:56 2021
0,0,0,BestMan1069 (BestMan),Re,Sun May 16 08:57:15 2021
2,11,-9,archiu888 (邱屁邱喔),[問卦] 決策者是不是很衰,Sun May 16 03:08:00 2021
12,14,-2,Szss (Not yet),Re,Sun May 16 07:20:03 2021
7,4,3,abc12812 (),[問卦] 阿機師 到底犯了什麼錯?,Sun May 16 08:53:31 2021
30,8,22,MintSu (Simon),[問卦] +180算是直擊要害吧？,Sun May 16 08:05:43 2021
9,0,9,NocturneBoy (Mome_Nofriend),[問卦] 看好了 世界 我只是示範一次,Sun May 16 04:26:01 2021
8,0,8,yoyozone (佑佑弄),[問卦] 有沒有男優抽插在想什麼的瓜呢？,Sun May 16 05:26:44 2021
32,3,29,qqmaybenot (qq),[新聞] 雙北司機缺很大 公車減班等好久,Sun May 16 09:09:19 2021
3,0,3,milfguy (MILFGUY),[問卦] 這局火燒本能寺怎解？,Sun May 16 09:03:17 2021
12,2,10,juang1985 (綿羊咩咩咩),[問卦] 萬華毒窟.蘆洲獅子.武漢肺炎哪個汙名？,Sun May 16 07:31:54 2021
13,0,13,JimJackson (老JJ),[問卦] 看好了台股兩週內衝上兩萬點  有效嗎,Sun May 16 09:17:02 2021
4,0,4,whiteadam (blue eyes blue),Re,Sun May 16 01:53:30 2021
0,0,0,weiweiweber (嘻嘻笑),[問卦] 中場休息就先採訪MVP？,Sun May 16 09:42:17 2021
4,1,3,Nagato (長門),[問卦] 可以上班 那可以開會嗎?,Sun May 16 09:04:22 2021
0,0,0,poeta (鍵盤詩人),Re,Sun May 16 09:47:55 2021
0,0,0,theclgy2001 (幾分甜),Re,Sun May 16 09:43:32 2021
7,0,7,Townshend (Pete),[問卦] 為何都是某航的機師在搞事?,Sun May 16 09:07:48 2021
11,2,9,charco (胖虎想要變瘦虎),[問卦] 其實2021比2020慘很多吧!,Sun May 16 09:03:48 2021
13,2,11,scum5566 (你好宅),[問卦] 看好了世界 台灣只示範一次,Sun May 16 09:05:01 2021
2,1,1,lpbrother (LP哥(LP = Love & Peace)),[問卦] 今天PTT主機還會爆炸嗎？,Sun May 16 09:06:24 2021
5,1,4,shau7276 (蕭A),[問卦] 立Flag立多大會初四？,Sun May 16 08:41:54 2021
2,0,2,cartervun (卡特),[問卦] 有阿公店有沒有阿罵店,Sun May 16 07:08:38 2021
1312,23,1289,sleepun (九把乃),[問卦] 猜今天本土確診人數 第一個猜中1000p,Sun May 16 04:37:59 2021
2,0,2,ilanese (我寫故我在),Re,Sun May 16 08:44:04 2021
9,1,8,ayasesayuki (綾瀨紗雪),[問卦] 台G普篩能救台灣嗎？,Sun May 16 02:07:39 2021
2,0,2,thouloveme (赫赫),[問卦] 還有多少人喜歡白色的老大？,Sun May 16 09:19:41 2021
5,0,5,Behind4 (背後4),Re,Sun May 16 02:29:19 2021
16,4,12,longyin (龍吟很難嗎？為什麼),Re,Sun May 16 05:45:54 2021
3,0,3,fundme (芳米),[問卦] 臺電有勞動神鷹嗎,Sun May 16 03:19:15 2021
8,4,4,ben108472 (ben108472),[問卦] 那麼多重症病例為何昨天才確診？,Sun May 16 07:56:58 2021
5,0,5,abcgo (真冷的冬天),[問卦] JIZZ只想爽，全體火葬場,Sun May 16 08:52:22 2021
14,2,12,Alaba (六張犁餅餡),[問卦] 示範一次如果失敗不就很好笑,Sun May 16 07:34:48 2021
10,1,9,roygg (roygg),Re,Sun May 16 03:03:55 2021
3,0,3,peggyfang (佩佩),Re,Sun May 16 01:56:11 2021
12,3,9,devirnt (sheng),[問卦] 石門水庫0%？,Sun May 16 07:50:26 2021
31,4,27,emuless (emuless),[問卦] 有沒有只是范一次就把事情搞砸的八卦？,Sun May 16 08:09:17 2021
7,1,6,afacebook (gg),[問卦] 同島一命是黑菊姐發明的口號嗎?,Sun May 16 05:23:50 2021
10,0,10,bleachman (飛天雪狐),[問卦] 可以用這個代替手寫實名制嗎,Sun May 16 09:00:13 2021
3,7,-4,owo5487 (星之人),[問卦] 有沒有慶幸首長是他們...,Sun May 16 07:53:42 2021
2,5,-3,milk7763 (截圖換現金),[問卦] 天氣好暖啊,Sun May 16 08:04:52 2021
1,0,1,songgood (ilovegoodgame),[問卦] 女神跟工具人,Sun May 16 07:25:16 2021
20,3,17,XTaiwanAyin (正宗～台科大-東胤),[問卦] 雙響泡等於夏威夷冷凍披薩？,Sun May 16 03:48:58 2021
22,0,22,w1230319 (龜山金城武),Re,Sun May 16 05:49:38 2021
5,0,5,Mantz (Kim Chaemoo),Re,Sun May 16 04:20:44 2021
6,2,4,mango3888 (兔巴哥),[問卦] 有人也因為擔心疫情，恐慌還沒睡嗎？,Sun May 16 03:48:16 2021
1,0,1,nyjytdgjf (小贏娃),Re,Sun May 16 07:32:49 2021
2,2,0,rock720429 (可愛動物，勿摸!!),[問卦] 欸！國師真的這麼神嗎？,Sun May 16 09:35:48 2021
5,3,2,Ommmmmm5566 (有人責備我們不夠深入),[問卦] 阿Q臭臭鍋ㄑ哪ㄌ？,Sun May 16 04:12:25 2021
22,3,19,bezbol (o.o),[問卦] 貼一張你覺得最欠揍的臉,Sun May 16 08:16:58 2021
2,1,1,HDSM (Love Not Change  O'_'O),[問卦] 讓愛情退冰多久 才可以化為烏有？,Sun May 16 04:00:15 2021
10,0,10,cuteme5566 (高大你家人),[問卦] 女同事的鞋留在辦公室,Sun May 16 07:07:05 2021
0,0,0,orangelolly (我戀橘羅莉。夏流),[問卦] 這樣會觸法嗎? 有八卦嗎?,Sun May 16 09:23:45 2021
8,1,7,b1b2b3b4 (lemon),[問卦] 會拿爭鮮60元大干貝的都是什麼人?,Sun May 16 07:20:29 2021
1,0,1,shiaumei (shiaumei),[問卦] 看好了世界 肥宅只吃飯一次 ,Sun May 16 09:01:21 2021
0,0,0,direct (【強迫練鐵頭功】),Re,Sun May 16 09:31:03 2021
185,33,152,fawangching (李奧納多皮卡丘1980),[問卦] 這次疫情 是「台灣」史上最大危機嗎？,Sun May 16 08:30:30 2021
7,2,5,SUHU1985 (蘇胡一九八五),[問卦] 在茶室要喝什麼茶才專業,Sun May 16 09:07:54 2021
7,0,7,osalucard (墮落的月光),[問卦] 快篩國家隊什麼時候出場？,Sun May 16 07:02:50 2021
6,2,4,wujet09100 (噁爛臭酸肥宅),[問卦] 本土清0後要吃什麼慶祝,Sun May 16 02:16:15 2021
4,7,-3,abramtw (世界原來是如此耀眼啊),[問卦] 台灣只示範一次的英文廣告應該怎麼寫？,Sun May 16 09:20:55 2021
41,7,34,LoveMakeLove (民進党の狂犬),[問卦] 館長健身房能撐多久的八卦？,Sun May 16 08:12:47 2021
9,6,3,clessea (陽明就像大海),[爆卦] 不要再用手拍大西瓜了     ,Sun May 16 08:36:36 2021
7,2,5,SCEW (↑X↓B L Y R A),[問卦] 現在在屯貨的都是4%仔中共同路人嗎?,Sun May 16 07:50:55 2021
299,85,214,lance753 (液體狀的貓),[爆卦] 桃園市機師職業機師工會的聲明,Sun May 16 02:36:52 2021
18,4,14,topic21000 (topic21000),[問卦] 雙重國籍仔該何去何從？,Sun May 16 07:18:35 2021
3,0,3,blueline19 (胱汁液界聾),[問卦] 請問各位還記得三倍券嗎,Sun May 16 02:58:05 2021
17,3,14,kimo6414 (凡人皆有一死),[問卦] 台灣是不是落後世界一年,Sun May 16 01:45:59 2021
3,0,3,mean (低智商生活),Re,Sun May 16 07:18:00 2021
4,4,0,hunter0904 (態度),[問卦] 看好了世界？,Sun May 16 09:01:06 2021
4,1,3,dean1990 (狄恩院長),[問卦] 下一場人禍是什麼？,Sun May 16 08:50:55 2021
7,3,4,sulanpa (...),[問卦] 圖書館都關了 圖書館怪人何去何從？,Sun May 16 08:26:09 2021
4,2,2,love1500274 (CoWuCoWu),[問卦] 看NBA名人堂演講看到哭很正常嗎,Sun May 16 08:06:08 2021
0,0,0,ccyaztfe (best_troll_tw),Re,Sun May 16 09:44:35 2021
0,0,0,hat13201 (J D从),[問卦] 阿共的陰謀,Sun May 16 09:45:10 2021
0,6,-6,sekokawana (Seto),[問卦] 薩諾斯&奇異博士的防疫辦法.,Sun May 16 04:33:19 2021
2,2,0,bluebugi (布魯布吉(￣﹀￣)),"[問卦] 患難深化台美真情,反而要感謝飛鏢空姐嗎?",Sun May 16 02:19:37 2021
0,1,-1,lolic (lolic),[問卦] 你喜歡我的歌嗎？ 這裡的歌 有沒有你的心,Sun May 16 08:40:18 2021
7,0,7,zakijudelo (Zack),[問卦] 有人也會忍不住想去吃囤貨？,Sun May 16 08:33:06 2021
3,0,3,shandowcat (貓影),[問卦] 台灣學生484 hen可憐,Sun May 16 08:40:02 2021
18,2,16,zzahoward (Cheshire Cat),[問卦] 在家上班到底好還是不好啊,Sun May 16 08:58:19 2021
133,8,125,fraternity (聽說小新比魯夫聰明),[問卦] 認真問，要怎麼在新聞上表達「做愛」呢,Sun May 16 02:34:36 2021
7,1,6,bezbol (o.o),[問卦] 華航空姐要賣多少茶才能彌補經濟損失,Sun May 16 03:05:36 2021
12,2,10,addison123 (鄉下小鮮肉),[問卦] 怎麼都沒看到華航高層出來謝罪？,Sun May 16 08:01:27 2021
7,1,6,bluebluelan (校内写生大会チャンピオ),[問卦] 白金之星會說 看好了世界 我只示範一次?,Sun May 16 03:16:18 2021
7,1,6,kidujef (anaivano),[問卦] 惡靈古堡真實上演?,Sun May 16 01:56:56 2021
6,0,6,lelena (智慧之神-透特),"[問卦] 抗疫英雄小黃,還能再領6萬嗎的八卦?",Sun May 16 09:29:14 2021
17,1,16,Ifault (Not my fault),[問卦] 升級到四級，算解除三級嗎？,Sun May 16 05:42:54 2021
26,10,16,zakijudelo (Zack),[問卦] 政府是否該“強烈建議”房東暫時降租金,Sun May 16 09:27:35 2021
9,4,5,andrew954 (andrew954),[問卦] 有人的公司已經啟動在家上班了嗎？,Sun May 16 02:38:00 2021
14,7,7,ceramicfa (ceramicfa),[問卦] 慘了 頭痛喉嚨痛,Sun May 16 01:47:29 2021
3,1,2,squard (sun),Re,Sun May 16 05:33:03 2021
4,1,3,huabandd (我是阿肥巴你頭),Re,Sun May 16 01:58:10 2021
1,0,1,CuLiZn5566 (同理心5566),Re,Sun May 16 04:17:31 2021
5,3,2,NCKUFatPork (成大肥宅悲歌),[問卦] 國外的鄉民正要回台灣的各位在想什麼?,Sun May 16 07:29:16 2021
